EA ./pics/colorstone.xpm
SO ./pics/wood.xpm
WE ./pics/greystone.xpm
NO ./pics/purplestone.xpm


F  20,100,53
C  0,31,50 


        1111111111111111111111111
        1000000000110000100000001
        1011000001110000100000001
        1001000000000000000E00011
1111111110110000011100000000000001
100000000011000001110111111111111                  
11110111111111011100000010001    
11110111111111011101010010001    
1100000011010111110000001000111  
10000000000001 1001100000010011  
100000000000001011010100100011   
1100000111010101111101111000111  
11110111 1110101 101111010001    
 11111111 1111111 111111111111   
