EA ./pics/colorstone.xpm
SO ./pics/wood.xpm
WE ./pics/greystone.xpm
NO ./pics/purplestone.xpm


F  220,100,253
C  225,31,30 


        1111111111111111111111111
        1000000000110000100000001
        1011000001110000100000001
        100100W000000010000000001
111111111011000001110000000000001
100000000011000001110111111111111
11111111111111111111111111111    
             111                 
11111111111111111111111111111    
11110111111111011100000010001    
11110111111111011101010010001    
1100000011010111110000001000111  
10000000000001 1001100000010011  
100000000000001011010100100011   
1100000111010101111101111000111  
11110111 1110101 101111010001    
 11111111 1111111 111111111111   
