WE ./pics/greystone.xpm
EA ./pics/greystone4.xpm
SO ./pics/greystone2.xpm
NO ./pics/greystone3.xpm

F 240,248,255
C 100,149,237


1111111111111111111111
10000000000S0000000001
1000000000000000000001
1000000000000000000001
1001111001111001111001
1001111001111001111001
1000000000000000000001
1001111001111001111001
1001111001111001111001
1000000000000000000001
1001111001111001111001
1001111001111001111001
1000000000000000000001
1000000000000000000001
1000000000000000000001
1111111111111111111111