EA ./pics/colorstone.xpm
SO ./pics/wood.xpm
WE ./pics/greystone.xpm
NO ./pics/purplestone.xpm

F 255,255,255


C 0,0,0


111111111111111
1000000000000W1
100000000000001
100111111111001
1001       1001
1001       1001
1001111    1001
100000111110001
100000000000001
111111110011111 
       1001
       1001
       10011111111111111111
       10000000000000000001
       11111111111111111101
                     111101
                     111101
                     111101
                     111101
                     111101
                     111101
                     111101
111111111111111111111100001
       11111111111111111101111111111111
       11111111111111111100000000000001
       11111111111111111111000000000001
       11111111111111111111000000000001
       11111111111111111111000000000001
       11111111111111111111000000000001
       11111111111111111111000000000001
       11111111111111111111111111111111
































