NO ./assests/textures/kanzee5.xpm
SO ./assests/textures/kanzee2.xpm
EA ./assests/textures/kanzee3.xpm
WE ./assests/textures/kanzee4.xpm
F 220,100,0
C 225,30,0




1111111111111111111111
1000000000000011111111
100010000000N011111111
1000100000000011111111
1000101000000011111111
1000000000000011111111
1111111111111111111111