EA ./pics/colorstone.xpm
SO ./pics/wood.xpm
WE ./pics/greystone.xpm
NO ./pics/purplestone.xpm

C 72,61,139
F 72,61,139


1111111111111111
1000000000000001
1000000000000001
1000000N00000001
1000000000000001
1000000000000001
1000000000000001
1000000000000001
1000000000000001
1000000000000001
1000000000000001
1000000000000001
1111111111111111