


EA ./path_to_the_east_texture.xpm
SO ./path_to_the_south_texture.xpm
WE ./path_to_the_west_texture.xpm                   
NO ./path_to_the_north_texture1.xpm        

F  220,100,253
C  225,31,30                   

        111111111111111111111111
        1000000000110000000000001
        1011000001110000000000001
        1001011000000000000000001
11111111011E00001110000000000001
100000000011000001110111111111111
11111111111111111111111111111
1
11111111111111111111111111111
11110111111111011100000010001
11110111111111011101010010001
1100000011010111110000001000111
10000000000001 1001100000010011
100000000000001011010100100011
1000000111010101111101111000111
10110111 1110101111111010011
11111111 1111111 1111111111111

