NO ./assests/textures/KU.xpm
SO ./assests/textures/GU.xpm
EA ./assests/textures/DO.xpm
WE ./assests/textures/BA.xpm

F 120,80,10
C 0,80,160




      
111111111111111
100000000000001
100000000000001
100000000000001
100000000000001
100000000000001
100000111000001
1000001N1000001
100000111000001
100000000000001
100000000000001
100000000000001
100000000000001
100000000000001
111111111111111




