
SO 
NO


WE 

    F 

111111
1N1111
111111

