
NO a

SO b

WE c

F d

111111
1N1111
111111

