NO a

sO b

WE s

EA z

F 1

C 2

11111
1N111
11111
