 
NO ../assests/textures/NO.xpm
SO ../assests/textures/SO.xpm
EA ../assests/textures/EA.xpm
WE ../assests/textures/WE.xpm

F 255,127,64
C 0,1,255





     111
     111
  111111111 111
  10000000W 001
  100000000 001
  111111111 111




