 
NO ../assests/textures/NO.xpm
SO ../assests/textures/SO.xpm
EA ../assests/textures/EA.xpm
WE ../assests/textures/WE.xpm

F 255,127,64
C 0,1,255





     111
     111
  11111111E111
  100000000001
  100000000001
  111111111111




