
EA ./pics/colorstone.xpm
SO ./pics/wood.xpm
WE ./pics/greystone.xpm
NO ./pics/purplestone.xpm

F 255,127,64





     111
     111
  111111111111
  10000000W001
  100000000001
  111111111111




