NO ./assests/textures/invalid.xpm
SO ./assests/textures/invalid.xpm
EA ./assests/textures/invalid.xpm
WE ./assests/textures/invalid.xpm

F 120,80,10
C 0,80,160




1111111111111111111111
1000000000000N11111111
1000100000000011111111
1000100000000011111111
1000101000000011111111
1000000000000011111111
1111111111111111111111
